Titre:Facile

W....W.....
W.B..W.....
W....W.....
W....W.....
W..S.......
W....W.....
W....W.....
W....W.....
W....W....W

..T........
...........
...........
...........
...........
...........
...........
...........
...........

4
3
0
6
[]