Titre:map6
WWWWWWW
WWWTT.W
WWW...W
WWWW.WW
WS.B.WW
W.B..WW
W..WWWW
WWWWWWW
